
*****단어/개수 분석결과*****

value = possibility         	count = 1
value = copier              	count = 1
value = same                	count = 2
value = 1                   	count = 1
value = 5                   	count = 1
value = narratives          	count = 1
value = the                 	count = 34
value = a                   	count = 10
value = i                   	count = 19
value = m                   	count = 3
value = s                   	count = 5
value = t                   	count = 1
value = sales               	count = 1
value = last                	count = 1
value = never               	count = 1
value = passionate          	count = 1
value = only                	count = 1
value = appreciate          	count = 1
value = dear                	count = 1
value = top                 	count = 1
value = original            	count = 1
value = save                	count = 1
value = administrative      	count = 1
value = bookkeeper          	count = 1
value = line                	count = 1
value = over                	count = 1
value = literally           	count = 1
value = conformed           	count = 1
value = thrive              	count = 1
value = two                 	count = 1
value = year                	count = 1
value = presentation        	count = 1
value = edited              	count = 1
value = renderings          	count = 1
value = fan                 	count = 1
value = about               	count = 1
value = industries          	count = 1
value = would               	count = 1
value = checked             	count = 1
value = materials           	count = 1
value = position            	count = 1
value = generally           	count = 1
value = application         	count = 1
value = for                 	count = 4
value = addition            	count = 1
value = product             	count = 1
value = coordinator         	count = 1
value = throughout          	count = 1
value = been                	count = 1
value = tasks               	count = 1
value = new                 	count = 5
value = every               	count = 1
value = gatekeeper          	count = 1
value = skills              	count = 1
value = not                 	count = 3
value = featured            	count = 1
value = used                	count = 1
value = guidelines          	count = 1
value = award               	count = 1
value = becoming            	count = 1
value = hall                	count = 1
value = runs                	count = 1
value = believe             	count = 1
value = hats                	count = 1
value = provided            	count = 1
value = know                	count = 2
value = division            	count = 1
value = that                	count = 4
value = qualifications      	count = 1
value = fanatic             	count = 1
value = grant               	count = 2
value = this                	count = 3
value = one                 	count = 1
value = candidate           	count = 1
value = career              	count = 1
value = companies           	count = 1
value = bring               	count = 1
value = attention           	count = 1
value = made                	count = 1
value = was                 	count = 2
value = her                 	count = 1
value = does                	count = 1
value = out                 	count = 2
value = manager             	count = 1
value = involved            	count = 2
value = am                  	count = 2
value = an                  	count = 3
value = targaryen           	count = 1
value = as                  	count = 6
value = at                  	count = 2
value = visible             	count = 1
value = make                	count = 1
value = by                  	count = 1
value = who                 	count = 1
value = why                 	count = 1
value = enjoy               	count = 1
value = many                	count = 1
value = after               	count = 1
value = submit              	count = 1
value = in                  	count = 7
value = is                  	count = 2
value = it                  	count = 6
value = website             	count = 1
value = tombs”              	count = 1
value = finished            	count = 1
value = touch               	count = 1
value = recent              	count = 1
value = me                  	count = 1
value = my                  	count = 4
value = consideration       	count = 1
value = no                  	count = 1
value = of                  	count = 10
value = mundane             	count = 1
value = certainly           	count = 1
value = so                  	count = 1
value = and                 	count = 19
value = result              	count = 1
value = to                  	count = 13
value = resume              	count = 1
value = up                  	count = 1
value = us                  	count = 1
value = ve                  	count = 3
value = are                 	count = 2
value = art                 	count = 1
value = your                	count = 1
value = five                	count = 1
value = hiring              	count = 1
value = flexible            	count = 1
value = entire              	count = 1
value = thrilled            	count = 1
value = detail              	count = 1
value = details             	count = 1
value = enthusiasm          	count = 1
value = sincerely           	count = 1
value = genuinely           	count = 1
value = guru                	count = 1
value = catelyn             	count = 1
value = version             	count = 1
value = technology          	count = 1
value = marketing           	count = 1
value = stunning            	count = 1
value = longtime            	count = 1
value = westeros            	count = 4
value = mostly              	count = 1
value = campaign            	count = 1
value = isn                 	count = 1
value = years               	count = 1
value = days                	count = 2
value = regards             	count = 1
value = level               	count = 2
value = project             	count = 3
value = what                	count = 1
value = work                	count = 1
value = proposal            	count = 1
value = experience          	count = 1
value = when                	count = 1
value = supporter           	count = 1
value = vision              	count = 1
value = opportunity         	count = 1
value = but                 	count = 2
value = admin               	count = 1
value = professional        	count = 1
value = whiz                	count = 1
value = responsive          	count = 1
value = formatted           	count = 1
value = built               	count = 1
value = excited             	count = 1
value = page                	count = 1
value = coordinating        	count = 1
value = exactly             	count = 1
value = from                	count = 3
value = can                 	count = 1
value = making              	count = 1
value = earliest            	count = 1
value = sure                	count = 2
value = you                 	count = 4
value = value               	count = 1
value = since               	count = 1
value = particularly        	count = 2
value = want                	count = 1
value = small               	count = 1
value = rfp                 	count = 1
value = discuss             	count = 1
value = awesome             	count = 1
value = environment         	count = 1
value = also                	count = 2
value = head                	count = 1
value = ground              	count = 1
value = building            	count = 1
value = attached            	count = 1
value = stark               	count = 1
value = being               	count = 2
value = wearing             	count = 1
value = applying            	count = 1
value = comes               	count = 1
value = warmest             	count = 1
value = already             	count = 1
value = will                	count = 2
value = organization        	count = 1
value = perfect             	count = 1
value = variety             	count = 1
value = closing             	count = 1
value = here                	count = 1
value = diverse             	count = 1
value = with                	count = 3
value = roles               	count = 1
value = forward             	count = 1
value = enthusiastic        	count = 1
value = least               	count = 2
value = castle              	count = 6
value = just                	count = 1
value = million             	count = 1
value = great               	count = 3
value = throne              	count = 1
value = say                 	count = 1
value = see                 	count = 2
value = murals              	count = 1
value = she                 	count = 3
value = look                	count = 1
value = nice                	count = 1
value = hearing             	count = 1
value = letter              	count = 3
value = meeting             	count = 1
value = proofed             	count = 1
value = asset               	count = 1
value = love                	count = 2
value = 200                 	count = 1
value = spreadsheets        	count = 1
value = paper               	count = 1
value = reality             	count = 1
value = team                	count = 1
value = meet                	count = 1
value = following           	count = 1
value = vintage             	count = 1
value = generic             	count = 1
value = tells               	count = 1
value = specific            	count = 1
value = projects            	count = 1
value = almost              	count = 1
value = where               	count = 2
value = movement            	count = 1
value = prepping            	count = 1
value = ten                 	count = 1
